#,#,#,#,#,#,#,#,#,#
#, , , ,#,#,#, , ,#
#, ,#,#, , , , ,#,#
#, , , , ,#,#, ,#,#
#,#, ,#, , ,#,#,#,#
#, , ,#,#, , , , ,#
#, ,#,#,#, , , , ,#
#, , , ,#, , , , ,#
#,#, ,#,#, ,#, ,#,#
#,#,#,#,#,#,#,#,#,#
