#, #, #, #, #, #, #, #, #, #
#, , , #, #, , #, #, #, #
#, , #, #, , , , , #, #
#, , , , , #, #, , #, #
#, #, , #, , , #, #, #, #
#, , , #, #, , , #, , #
#, , #, #, #, , #, #, , #
#, , , , #, , , , , #
#, #, , #, #, , #, , #, #
#, #, #, #, #, #, #, #, #, #
