#,#,#,#,#,#,#,#,#,#
#, , , ,#,#,#, , ,#
#, ,#,#, , , , ,#,#
#, , , , ,#,#, ,#,#
#,#, ,#, , ,#,#,#,#
#, , ,#,#, , ,#, ,#
#, ,#,#,#, ,#,#, ,#
#, , , ,#, , , , ,#
#,#, ,#,#, ,#, ,#,#
#,#,#,#,#,#,#,#,#,#
